1111111111
1..m.....1
1........1
1.h...e..1
1.....d..1
1....m...1
1........1
1......e.1
1......e.1
1111111111